7 7 7 7 7 7 7 7 7 7 7 7 7 7 7 7 7 7 7 7 7 7 7 7 7 7 7 7 7 7 7 7 7 7 7 7 7 7 7 7 7 7 7 7 7 7 7 7 7 7 
7 37 1 1 37 1 1 37 1 1 37 1 1 37 1 1 37 1 1 37 1 1 37 1 1 37 1 1 37 1 1 37 1 1 37 1 1 37 1 1 37 1 1 37 1 1 37 1 1 7 
7 36 1 1 36 1 1 36 1 1 36 1 1 36 1 1 36 1 1 36 1 1 36 1 1 36 1 1 36 1 1 36 1 1 36 1 1 36 1 1 36 1 1 36 1 1 36 1 1 7 
7 1 1 1 1 1 1 1 1 1 1 1 1 1 1 1 1 1 1 1 1 1 1 1 1 1 1 1 1 1 1 1 1 1 1 1 1 1 1 1 1 1 1 1 1 1 1 1 1 7 
7 1 1 1 1 1 1 1 1 1 1 1 1 1 1 1 1 1 1 1 1 1 1 1 1 1 1 1 1 1 1 1 1 1 1 1 1 1 1 1 1 1 1 1 1 1 1 1 1 7 
7 1 1 1 1 1 1 1 1 1 1 1 1 1 1 1 1 1 1 1 1 1 1 1 1 1 1 1 1 1 1 1 1 1 1 1 1 1 1 1 1 1 1 1 1 1 1 1 1 7 
7 35 1 1 35 1 1 35 1 1 35 1 1 35 1 1 35 1 1 35 1 1 35 1 1 1 1 1 1 1 1 35 1 1 35 1 1 35 1 1 35 1 1 35 1 1 35 1 1 7 
7 34 1 1 34 1 1 34 1 1 34 1 1 34 1 1 34 1 1 34 1 1 34 1 1 1 1 1 1 1 1 34 1 1 34 1 1 34 1 1 34 1 1 34 1 1 34 1 1 7 
7 7 7 7 7 7 7 7 7 7 7 7 7 7 7 7 7 7 7 7 7 7 7 7 31 31 31 31 31 31 7 7 7 7 7 7 7 7 7 7 7 7 7 7 7 7 7 7 7 7 
7 3 4 4 4 4 4 4 4 4 4 4 4 4 4 4 4 4 4 1 7 1 1 24 1 1 1 1 1 1 23 1 1 1 1 1 1 7 12 12 12 12 12 11 12 12 12 12 12 7 
7 3 6 6 6 6 6 6 6 6 6 6 6 6 6 6 6 6 5 1 7 1 1 1 1 1 1 17 17 17 17 1 1 1 1 1 1 7 13 13 13 13 13 13 13 13 13 1 1 7 
7 3 6 6 6 6 6 6 6 6 6 6 6 6 6 6 6 6 5 1 7 1 1 1 1 17 17 13 13 13 13 16 1 1 1 1 1 7 13 13 13 13 13 13 13 1 1 1 1 7 
7 3 6 6 6 6 6 6 6 6 6 6 6 6 6 6 6 6 5 1 1 1 1 1 15 13 13 13 13 13 13 17 17 1 1 1 1 7 13 33 33 33 33 33 33 33 33 33 1 7 
7 3 6 6 6 6 6 6 6 6 6 6 6 6 6 6 6 6 5 1 1 1 1 1 15 13 13 13 13 13 13 13 13 16 1 1 1 1 13 33 33 33 33 33 33 33 33 33 1 7 
7 3 6 6 6 6 6 6 6 6 6 6 6 6 6 6 6 6 5 1 1 1 1 1 1 15 13 13 13 13 13 13 13 17 1 1 1 1 13 33 33 33 33 33 33 33 33 33 13 7 
7 3 6 6 6 6 6 6 6 6 6 6 6 6 6 6 6 6 5 1 7 1 1 1 1 15 13 13 13 13 13 13 13 13 16 1 1 1 13 33 33 33 33 33 33 33 33 33 13 7 
7 3 6 6 6 6 6 6 6 6 6 6 6 6 6 6 6 6 5 1 7 1 1 1 1 1 14 14 14 14 14 14 14 13 16 1 1 1 13 33 33 33 33 33 33 33 33 33 13 7 
7 3 2 2 2 2 2 2 2 2 2 2 2 2 2 2 2 2 2 1 7 1 1 1 1 1 1 1 1 1 1 1 1 14 1 1 1 7 1 33 33 33 33 33 33 33 33 33 13 7 
7 7 7 7 7 7 7 7 7 7 7 7 7 7 7 7 7 7 7 7 7 7 7 7 7 7 7 7 7 31 31 7 7 7 7 7 7 7 1 33 33 33 33 33 33 33 33 33 13 7 
7 40 40 40 40 40 40 40 40 40 40 40 40 40 40 40 40 40 40 40 40 40 40 40 40 40 40 40 40 39 39 40 40 40 40 40 40 7 1 1 1 13 13 13 13 13 13 13 13 7 
7 40 39 39 39 39 39 39 39 39 39 39 39 39 39 39 39 39 39 39 39 39 39 39 39 39 39 39 39 39 39 39 39 39 39 39 40 7 1 1 13 13 13 13 13 13 13 13 13 7 
7 40 39 39 39 39 39 39 39 39 39 39 39 39 39 39 39 39 39 39 39 39 39 39 39 39 39 39 39 39 39 39 39 39 39 39 40 7 7 7 7 7 7 7 7 7 7 7 7 7 
7 40 39 39 39 39 39 39 39 39 39 39 39 39 39 39 39 39 39 39 39 39 39 39 39 39 39 39 39 39 39 39 39 39 39 39 40 7 0 0 0 0 0 0 0 0 0 0 0 7 
7 40 39 39 39 39 39 39 39 39 39 39 39 39 39 39 39 39 39 39 39 39 39 39 39 39 39 39 39 39 39 39 39 39 39 39 40 7 0 0 0 0 0 0 0 0 0 0 0 7 
7 40 39 39 39 39 39 39 39 39 39 39 39 39 39 39 39 39 39 39 39 39 39 39 39 39 39 39 39 39 39 39 39 39 39 39 40 7 0 0 0 0 0 0 0 0 0 0 0 7 
7 40 40 40 40 40 40 40 40 40 40 40 40 40 40 40 40 40 40 40 40 40 40 40 40 40 40 40 40 40 40 40 40 40 40 40 40 7 0 0 0 0 0 0 0 0 0 0 0 7 
7 7 7 7 7 7 7 7 7 7 7 7 7 7 7 7 7 7 7 7 7 7 7 7 7 7 7 7 7 7 7 7 7 7 7 7 7 7 0 0 0 0 0 0 0 0 0 0 0 7 
7 0 0 0 0 0 0 0 0 0 0 0 0 0 0 0 0 0 0 0 0 0 0 0 0 0 0 0 0 0 0 0 0 0 0 0 0 0 0 0 0 0 0 0 0 0 0 0 0 7 
7 0 0 0 0 0 0 0 0 0 0 0 0 0 0 0 0 0 0 0 0 0 0 0 0 0 0 0 0 0 0 0 0 0 0 0 0 0 0 0 0 0 0 0 0 0 0 0 0 7 
7 0 0 0 0 0 0 0 0 0 0 0 0 0 0 0 0 0 0 0 0 0 0 0 0 0 0 0 0 0 0 0 0 0 0 0 0 0 0 0 0 0 0 0 0 0 0 0 0 7 
7 0 0 0 0 0 0 0 0 0 0 0 0 0 0 0 0 0 0 0 0 0 0 0 0 0 0 0 0 0 0 0 0 0 0 0 0 0 0 0 0 0 0 0 0 0 0 0 0 7 
7 0 0 0 0 0 0 0 0 0 0 0 0 0 0 0 0 0 0 0 0 0 0 0 0 0 0 0 0 0 0 0 0 0 0 0 0 0 0 0 0 0 0 0 0 0 0 0 0 7 
7 0 0 0 0 0 0 0 0 0 0 0 0 0 0 0 0 0 0 0 0 0 0 0 0 0 0 0 0 0 0 0 0 0 0 0 0 0 0 0 0 0 0 0 0 0 0 0 0 7 
7 0 0 0 0 0 0 0 0 0 0 0 0 0 0 0 0 0 0 0 0 0 0 0 0 0 0 0 0 0 0 0 0 0 0 0 0 0 0 0 0 0 0 0 0 0 0 0 0 7 
7 0 0 0 0 0 0 0 0 0 0 0 0 0 0 0 0 0 0 0 0 0 0 0 0 0 0 0 0 0 0 0 0 0 0 0 0 0 0 0 0 0 0 0 0 0 0 0 0 7 
7 0 0 0 0 0 0 0 0 0 0 0 0 0 0 0 0 0 0 0 0 0 0 0 0 0 0 0 0 0 0 0 0 0 0 0 0 0 0 0 0 0 0 0 0 0 0 0 0 7 
7 0 0 0 0 0 0 0 0 0 0 0 0 0 0 0 0 0 0 0 0 0 0 0 0 0 0 0 0 0 0 0 0 0 0 0 0 0 0 0 0 0 0 0 0 0 0 0 0 7 
7 0 0 0 0 0 0 0 0 0 0 0 0 0 0 0 0 0 0 0 0 0 0 0 0 0 0 0 0 0 0 0 0 0 0 0 0 0 0 0 0 0 0 0 0 0 0 0 0 7 
7 0 0 0 0 0 0 0 0 0 0 0 0 0 0 0 0 0 0 0 0 0 0 0 0 0 0 0 0 0 0 0 0 0 0 0 0 0 0 0 0 0 0 0 0 0 0 0 0 7 
7 0 0 0 0 0 0 0 0 0 0 0 0 0 0 0 0 0 0 0 0 0 0 0 0 0 0 0 0 0 0 0 0 0 0 0 0 0 0 0 0 0 0 0 0 0 0 0 0 7 
7 0 0 0 0 0 0 0 0 0 0 0 0 0 0 0 0 0 0 0 0 0 0 0 0 0 0 0 0 0 0 0 0 0 0 0 0 0 0 0 0 0 0 0 0 0 0 0 0 7 
7 0 0 0 0 0 0 0 0 0 0 0 0 0 0 0 0 0 0 0 0 0 0 0 0 0 0 0 0 0 0 0 0 0 0 0 0 0 0 0 0 0 0 0 0 0 0 0 0 7 
7 0 0 0 0 0 0 0 0 0 0 0 0 0 0 0 0 0 0 0 0 0 0 0 0 0 0 0 0 0 0 0 0 0 0 0 0 0 0 0 0 0 0 0 0 0 0 0 0 7 
7 0 0 0 0 0 0 0 0 0 0 0 0 0 0 0 0 0 0 0 0 0 0 0 0 0 0 0 0 0 0 0 0 0 0 0 0 0 0 0 0 0 0 0 0 0 0 0 0 7 
7 0 0 0 0 0 0 0 0 0 0 0 0 0 0 0 0 0 0 0 0 0 0 0 0 0 0 0 0 0 0 0 0 0 0 0 0 0 0 0 0 0 0 0 0 0 0 0 0 7 
7 0 0 0 0 0 0 0 0 0 0 0 0 0 0 0 0 0 0 0 0 0 0 0 0 0 0 0 0 0 0 0 0 0 0 0 0 0 0 0 0 0 0 0 0 0 0 0 0 7 
7 0 0 0 0 0 0 0 0 0 0 0 0 0 0 0 0 0 0 0 0 0 0 0 0 0 0 0 0 0 0 0 0 0 0 0 0 0 0 0 0 0 0 0 0 0 0 0 0 7 
7 0 0 0 0 0 0 0 0 0 0 0 0 0 0 0 0 0 0 0 0 0 0 0 0 0 0 0 0 0 0 0 0 0 0 0 0 0 0 0 0 0 0 0 0 0 0 0 0 7 
7 0 0 0 0 0 0 0 0 0 0 0 0 0 0 0 0 0 0 0 0 0 0 0 0 0 0 0 0 0 0 0 0 0 0 0 0 0 0 0 0 0 0 0 0 0 0 0 0 7 
7 7 7 7 7 7 7 7 7 7 7 7 7 7 7 7 7 7 7 7 7 7 7 7 7 7 7 7 7 7 7 7 7 7 7 7 7 7 7 7 7 7 7 7 7 7 7 7 7 7 
