7777777777777777777777777777777777777777777777777777777777777777777777777777777777777777777777777777
7777777777777777777777777777777777777777777777777777777777777777777777777777777777777777777777777777
7755555555555556555555555555555555555555555555555555555555555555555555555555555555555555555555555577
7757777777777777775444444044444404444444577777777777777777777750000000000000000000000000000000000577
7757777777777777775044444404444440444444577777777777777777777750000000000000000000000000000000000577
7757777777777777775004444440444444044444577777777777777777777750000000000000000000000000000000000577
7757777777777777775000444444044444404444577777777777777777777750000000000000000000000000000000000577
7755655655655555555000000000000000000006556555555565555555556550000000000000000000000000000000000577
7750000000000000000000000000000000000000550000000000000000000000000000000000000000000000000000000577
7750000000000000000000000000000000000000550000000000000000000000000000000000000000000000000000000577
7750000000000000000000000000000000000000550000000000000000000000000000000000000000000000000000000577
7750000000000000000000000000000000000000555555555555555555555555555555555555555553555555555555555577
7750000000000000000000000000000000000000550022122202000000000000000000000000000000000000000000000577
7750000000000000000000000000000000000000551122121120002000000000000000000000000000000000000000000577
7750000000000000000000000000000000000000550022222221110000000000000000000000000000000000000000000577
7750000000000000000000000000000000000000550022222222222222000000000000000000000000000000000000000577
7755555555555555555553555555555555555555555555555550000000000000000000000000000000000000000000000577
7750000000000000000000000000000000000000000000000550000000000000000000000000000000000000000000000577
7750000000000000000000000000000000000000000000000550000000000000000000000000000000000000000000000577
7750000000000000000000000000000000000000000000000555555555555555555555553333333555555555555555555577
7750000000000000000000000000000000000000000000000550000000000000000000000000000000000000000000000577
7750000000000000000000000000000000000000000000000550000000000000000000000000000000000000000000000577
7755556555555555555533335555555555555555555555555550000000000000000000000000000000000000000000000577
7750000000000000000000000000000055004444440444444044444000000000000000000000000000000000000000000577
7750000000000000000000000000000055000444444044444404444000000000000000000000000000000000000000000577
7750000000000000000000000000000055004444440444444044444000000000000000000000000000000000000000000577
7750000000000000000000000000000055044444404444440444444000000000000000000000000000000000000000000577
7750000000000000000000000000000055444444044444404444444000000000000000000000000002222222222222200577
7750000000000000000000000000000055044444404444440444444000000000000000000000000000011111222222000577
7750000000000000000000000000000055004444440444444044444000000000000000000000000000000220211200120577
7750000000000000000000000000000055000444444044444404444000000000000000000000000000000002222221000577
7750000000000000000000000000000055555555555555555655555555555555555533355555555555555565555555555577
7750000000000000000000000000000000000050000000000000000000000000000000000000000000000000000000000577
7750000000000000000000000000000000000005000000000000000000000000000000000000000000000000000000000577
7750000000000000000000000000000000000000500000000000000000000000000000000000000000000000000000000577
7750000000000000000000000000000000000000200000000000000055555555555555555555555555000000000000000577
7750000000000000000000000000000000000002220000000000000057777777777777777777777775000000000000000577
7750000000000000000000000000000000000000200000000000000057777777777777777777777775000000000000000577
7750000000000000000000000000000000000000500000000000000057777777777777777777777775000000000000000577
7750000000000000000000000000000000000005000000000000000057777777777777777777777775000000000000000577
7755555555555553333335555555555555555550000000000000000057777777777775555565555555000000000000000577
7750000000000000000000000000000000000550000000000000000057777777777775000000000000000000000000000577
7750000000000000000000000000000000000550000000000000000057777777777775000000000000000000000000000577
7750000000000000000000000000000000000550000000000000000057777777777775000000000000000000000000000577
7750000000000000000000000000000000000550000000000000000055556555555655000000000000000000000000000577
7750000000000000000000000000000000000550000000000000000000000000000000000000000000000000000000000577
7750000000000000000000000000000000000550000000000000000000000000000000000000000000000000000000000577
7755555555555555555555555555555555555555555555555555555555555555555555555555555555555555555555555577
7777777777777777777777777777777777777777777777777777777777777777777777777777777777777777777777777777
7777777777777777777777777777777777777777777777777777777777777777777777777777777777777777777777777777
