6 6 6 6 6 6 6 6 6 6 6 6 6 6 6 6 6 6 6 6 6 6 6 6 6 6 6 6 6 6 6 6 6 6 6 6 6 6 6 6 6 6 6 6 6 6 6 6 6 6 
6 6 6 6 6 6 6 6 6 6 6 6 6 6 7 7 7 7 7 7 7 7 7 7 7 7 7 7 7 7 7 7 7 7 7 7 7 7 6 6 6 6 6 6 6 6 6 6 6 6 
6 6 6 6 6 6 6 6 6 7 7 7 7 7 7 6 6 6 6 6 6 6 6 6 6 6 6 6 6 6 6 6 6 6 6 6 6 6 7 7 7 7 7 6 6 6 6 6 6 6 
6 6 6 6 6 6 6 7 7 7 6 6 6 6 6 6 6 6 6 6 6 6 6 6 6 6 6 6 6 6 6 6 6 6 6 6 6 6 6 6 6 6 7 7 7 6 6 6 6 6 
6 6 6 6 6 6 7 7 6 6 6 6 17 17 17 17 17 17 17 17 17 17 17 17 17 17 17 17 6 6 6 6 6 6 6 6 6 6 6 6 6 6 6 6 7 7 6 6 6 6 
6 6 6 6 6 7 7 6 6 6 6 15 13 13 13 13 13 13 13 13 13 13 13 13 13 13 13 13 16 6 6 6 6 6 6 6 6 6 6 6 6 6 6 6 6 7 7 6 6 6 
6 6 6 6 7 7 6 6 6 6 6 15 13 13 13 13 13 13 13 13 13 13 13 13 13 13 13 13 16 6 6 6 6 6 6 6 6 6 6 6 6 6 6 6 6 6 7 6 6 6 
6 6 6 7 6 6 6 6 6 6 6 15 13 13 13 13 13 13 13 13 13 13 13 13 13 13 13 13 16 6 6 6 6 6 6 6 6 6 6 6 6 6 6 6 6 6 7 7 6 6 
6 6 6 7 6 6 6 6 6 6 6 6 14 13 13 13 13 13 13 13 13 13 13 13 13 14 14 14 6 6 6 6 6 6 6 6 6 6 6 6 6 6 6 6 6 6 6 7 6 6 
6 6 6 7 6 6 6 6 6 6 6 6 15 13 13 13 13 13 13 13 13 13 13 13 16 6 6 6 6 6 6 6 6 6 6 6 6 6 6 6 6 6 6 6 6 6 6 7 6 6 
6 6 6 7 6 6 6 6 6 6 6 6 15 13 13 13 13 13 13 13 13 13 13 13 16 6 6 6 6 6 6 6 6 6 6 6 6 6 6 6 6 6 6 6 6 6 6 7 6 6 
6 6 6 7 6 6 6 6 6 6 6 6 15 13 13 13 13 13 13 13 13 13 13 13 16 6 6 6 6 6 6 6 6 6 6 6 6 6 6 6 6 6 6 6 6 6 6 7 6 6 
6 6 6 7 6 6 6 6 6 6 6 6 15 13 13 13 13 13 13 16 14 14 14 14 6 6 6 6 6 6 6 6 6 6 6 6 6 6 6 6 6 6 6 6 6 6 6 7 6 6 
6 6 6 7 6 6 6 6 6 6 6 6 6 14 14 14 14 14 14 14 6 6 6 6 6 6 6 6 6 6 6 6 6 6 6 6 6 6 6 6 6 6 6 6 6 6 6 7 6 6 
6 6 6 7 6 6 6 6 6 6 6 6 6 6 6 6 6 6 6 6 6 6 6 6 6 6 6 6 6 6 6 6 6 6 6 6 6 6 6 6 6 6 6 6 6 6 6 7 6 6 
6 6 6 7 6 6 6 6 6 6 6 6 6 6 6 6 6 6 6 6 6 6 6 6 17 17 17 17 17 17 17 17 17 17 17 17 17 17 17 17 6 6 6 6 6 6 6 7 6 6 
6 6 6 7 6 6 6 6 6 6 6 6 6 6 6 6 6 6 6 6 6 6 6 6 13 13 13 13 13 13 13 13 13 13 13 13 13 13 13 13 16 6 6 6 6 6 6 7 6 6 
6 6 6 7 6 6 6 6 6 6 6 6 6 6 6 6 6 6 6 6 17 17 17 17 13 13 13 13 13 13 13 13 13 13 13 13 13 13 13 13 16 6 6 6 6 6 6 7 6 6 
6 6 6 7 6 6 6 6 6 6 6 6 6 6 6 6 6 6 6 15 13 13 13 13 13 13 13 13 13 13 13 13 13 13 13 13 13 13 13 13 16 6 6 6 6 6 6 7 6 6 
6 6 6 7 6 6 6 6 6 6 6 6 6 6 6 6 6 6 6 15 13 13 13 13 13 13 13 13 13 13 13 13 13 13 13 13 13 13 13 13 16 6 6 6 6 6 6 7 6 6 
6 6 6 7 6 6 6 6 6 6 6 6 6 6 6 6 6 6 6 15 13 13 13 13 13 13 13 13 13 13 13 13 13 13 13 13 13 13 13 13 16 6 6 6 6 6 6 7 6 6 
6 6 6 7 6 6 6 6 6 6 6 6 6 6 6 6 6 6 6 15 13 13 13 13 13 13 13 13 13 13 13 13 13 13 13 13 13 13 13 13 16 6 6 6 6 6 6 7 6 6 
6 6 6 7 6 6 6 6 6 6 6 6 6 6 6 6 6 6 6 15 13 13 13 13 13 13 13 13 13 13 13 13 13 13 13 13 13 13 13 13 16 6 6 6 6 6 6 7 6 6 
6 6 6 7 6 6 6 6 6 6 6 6 6 6 6 6 6 6 6 15 13 13 13 13 13 13 13 13 13 13 13 13 13 13 13 13 13 13 13 13 16 6 6 6 6 6 6 7 6 6 
6 6 6 7 6 6 6 6 6 6 6 6 6 6 6 6 6 6 6 15 13 13 13 13 13 13 13 13 13 13 13 13 13 13 13 13 13 13 13 13 16 6 6 6 6 6 6 7 6 6 
6 6 6 7 6 6 6 6 6 6 6 6 6 6 6 6 6 6 6 15 13 13 13 13 13 13 13 13 13 13 13 13 13 13 13 13 13 14 14 14 6 6 6 6 6 6 6 7 6 6 
6 6 6 7 6 6 6 6 6 6 6 6 6 6 6 6 6 6 6 15 13 13 13 13 13 13 13 13 13 13 13 13 13 13 13 13 14 6 6 6 6 6 6 6 6 6 6 7 6 6 
6 6 6 7 6 6 6 6 6 6 6 6 6 6 6 6 6 6 6 6 14 14 14 14 14 14 14 14 14 14 14 14 14 14 14 14 6 6 6 6 6 6 6 6 6 6 7 7 6 6 
6 6 6 7 6 6 6 6 6 6 6 6 6 6 6 6 6 6 6 6 6 6 6 6 6 6 6 6 6 6 6 6 6 6 6 6 6 6 6 6 6 6 6 6 6 7 7 6 6 6 
6 6 6 6 7 6 6 6 6 6 6 6 6 6 6 6 6 6 6 6 6 6 6 6 6 6 6 6 6 6 6 6 6 6 6 6 6 6 6 6 6 6 6 6 6 7 6 6 6 6 
6 6 6 6 7 7 6 6 6 6 6 6 6 6 6 6 6 6 6 6 6 6 6 6 6 6 6 6 6 6 6 6 6 6 6 6 6 6 6 6 6 6 6 6 6 7 6 6 6 6 
6 6 6 6 6 7 7 6 6 6 6 6 6 6 6 6 6 6 6 6 6 6 6 6 6 6 6 6 6 6 6 6 6 6 6 6 6 6 6 6 6 6 6 6 7 6 6 6 6 6 
6 6 6 6 6 6 7 7 6 6 6 6 6 6 6 6 6 6 6 6 6 6 6 6 6 6 6 6 6 6 6 6 6 6 6 6 6 6 6 6 6 6 6 6 7 6 6 6 6 6 
6 6 6 6 6 6 6 7 7 7 6 6 6 6 6 6 6 6 6 6 6 6 6 6 6 6 6 6 6 6 6 6 6 6 6 6 6 6 6 6 6 6 6 7 7 6 6 6 6 6 
6 6 6 6 6 6 6 6 6 7 7 6 6 6 6 6 6 6 6 6 6 6 6 6 6 6 6 6 6 6 6 6 6 6 6 6 6 6 6 6 6 6 7 7 6 6 6 6 6 6 
6 6 6 6 6 6 6 6 6 6 7 7 6 6 6 6 6 6 6 6 6 6 6 6 6 6 6 6 6 6 6 6 6 6 6 6 7 7 7 6 7 7 6 6 6 6 6 6 6 6 
6 6 6 6 6 6 6 6 6 6 6 7 7 7 7 7 7 6 6 6 6 6 38 38 6 6 6 6 6 6 7 7 7 7 7 7 6 6 6 6 6 6 6 6 6 6 6 6 6 6 
6 6 6 6 6 6 6 6 6 6 6 6 6 6 6 6 7 7 7 7 7 7 7 7 7 7 7 7 7 7 7 6 6 6 6 6 6 6 6 6 6 6 6 6 6 6 6 6 6 6 
6 6 6 6 6 6 6 6 6 6 6 6 6 6 6 6 6 6 6 6 6 6 6 6 6 6 6 6 6 6 6 6 6 6 6 6 6 6 6 6 6 6 6 6 6 6 6 6 6 6 
6 6 6 6 6 6 6 6 6 6 6 6 6 6 6 6 6 6 6 6 6 6 6 6 6 6 6 6 6 6 6 6 6 6 6 6 6 6 6 6 6 6 6 6 6 6 6 6 6 6 
6 6 6 6 6 6 6 6 6 6 6 6 6 6 6 6 6 6 6 6 6 6 6 6 6 6 6 6 6 6 6 6 6 6 6 6 6 6 6 6 6 6 6 6 6 6 6 6 6 6 
6 6 6 6 6 6 6 6 6 6 6 6 6 6 6 6 6 6 6 6 6 6 6 6 6 6 6 6 6 6 6 6 6 6 6 6 6 6 6 6 6 6 6 6 6 6 6 6 6 6 
0 0 0 0 0 0 0 0 0 0 0 0 0 0 0 0 0 0 0 0 0 0 0 0 0 0 0 0 0 0 0 0 0 0 0 0 0 0 0 0 0 0 0 0 0 0 0 0 0 0 
0 0 0 0 0 0 0 0 0 0 0 0 0 0 0 0 0 0 0 0 0 0 0 0 0 0 0 0 0 0 0 0 0 0 0 0 0 0 0 0 0 0 0 0 0 0 0 0 0 0 
0 0 0 0 0 0 0 0 0 0 0 0 0 0 0 0 0 0 0 0 0 0 0 0 0 0 0 0 0 0 0 0 0 0 0 0 0 0 0 0 0 0 0 0 0 0 0 0 0 0 
0 0 0 0 0 0 0 0 0 0 0 0 0 0 0 0 0 0 0 0 0 0 0 0 0 0 0 0 0 0 0 0 0 0 0 0 0 0 0 0 0 0 0 0 0 0 0 0 0 0 
0 0 0 0 0 0 0 0 0 0 0 0 0 0 0 0 0 0 0 0 0 0 0 0 0 0 0 0 0 0 0 0 0 0 0 0 0 0 0 0 0 0 0 0 0 0 0 0 0 0 
0 0 0 0 0 0 0 0 0 0 0 0 0 0 0 0 0 0 0 0 0 0 0 0 0 0 0 0 0 0 0 0 0 0 0 0 0 0 0 0 0 0 0 0 0 0 0 0 0 0 
0 0 0 0 0 0 0 0 0 0 0 0 0 0 0 0 0 0 0 0 0 0 0 0 0 0 0 0 0 0 0 0 0 0 0 0 0 0 0 0 0 0 0 0 0 0 0 0 0 0 
0 0 0 0 0 0 0 0 0 0 0 0 0 0 0 0 0 0 0 0 0 0 0 0 0 0 0 0 0 0 0 0 0 0 0 0 0 0 0 0 0 0 0 0 0 0 0 0 0 0 
