6 6 6 6 6 6 6 6 6 6 6 6 6 6 6 6 6 6 6 6 6 6 6 6 6 6 6 6 6 6 6 6 6 6 6 6 6 6 6 6 6 6 6 6 6 6 6 6 6 6 
6 6 6 6 6 6 6 6 6 6 6 6 6 6 6 6 6 6 6 6 6 6 6 6 6 6 6 6 6 6 6 6 6 6 6 6 6 6 6 6 6 6 6 6 6 6 6 6 6 6 
6 6 6 6 6 6 6 6 6 6 6 6 6 6 6 6 6 6 6 6 6 6 6 6 6 6 6 6 6 6 6 6 6 6 6 6 6 6 6 6 6 6 6 6 6 6 6 6 6 6 
6 6 6 6 7 7 7 7 7 7 7 7 7 7 7 7 7 7 7 7 7 7 7 7 7 7 7 7 7 7 7 7 7 7 7 7 7 7 7 7 7 7 7 7 7 7 6 6 6 6 
6 6 6 6 7 6 37 6 6 37 6 1 18 26 6 37 6 6 37 6 6 7 2 2 17 17 17 2 2 7 6 13 13 13 13 13 16 18 15 13 13 13 13 13 13 7 6 6 6 6 
6 6 6 6 7 6 36 6 6 36 6 6 6 6 6 36 6 6 36 6 6 7 1 15 13 13 13 16 3 7 15 13 13 13 13 13 13 17 13 13 13 13 13 13 13 7 6 6 6 6 
6 6 6 6 7 6 33 33 33 33 33 33 33 33 33 33 33 33 33 6 6 7 1 15 13 13 13 16 3 7 15 13 13 13 13 13 13 13 13 13 13 13 13 13 16 7 6 6 6 6 
6 6 6 6 7 6 33 33 33 33 33 33 33 33 33 33 33 33 33 6 6 7 1 1 14 13 14 1 3 7 6 14 14 14 14 14 14 14 14 14 14 15 13 13 16 7 6 6 6 6 
6 6 6 6 7 6 33 33 33 33 33 33 33 33 33 33 33 33 33 6 6 7 1 1 1 14 1 1 3 7 7 7 7 7 7 7 7 7 7 7 7 15 13 13 16 7 6 6 6 6 
6 6 6 6 7 6 33 33 33 33 33 33 33 33 33 33 33 33 33 6 6 7 1 1 1 1 1 1 1 7 25 2 2 2 2 2 2 2 2 6 7 6 14 14 6 7 6 6 6 6 
6 6 6 6 7 6 35 6 6 35 6 6 6 6 6 35 6 6 35 6 6 7 1 1 1 1 1 1 1 1 1 1 1 1 1 1 1 1 1 3 7 31 7 7 7 7 6 6 6 6 
6 6 6 6 7 6 34 6 6 34 6 6 6 6 6 34 6 6 34 6 6 7 1 1 1 1 1 1 3 7 25 1 1 17 17 1 1 1 1 1 26 1 23 7 7 7 7 7 7 6 
6 6 6 6 7 7 10 7 7 7 7 7 31 7 7 7 7 7 7 9 7 7 1 33 33 33 33 33 3 7 1 1 15 13 13 16 1 1 1 1 1 1 3 7 0 0 0 0 7 6 
6 6 6 6 7 5 1 1 1 1 1 24 1 23 1 1 1 1 1 1 1 1 1 33 33 33 33 33 3 7 1 15 13 13 13 13 16 1 1 1 1 1 3 7 0 0 0 0 7 6 
6 6 6 6 7 5 1 1 1 1 1 1 1 1 1 1 1 1 1 1 1 1 1 33 33 27 33 33 3 7 1 15 13 13 13 13 13 16 17 1 1 1 3 7 0 0 0 0 7 6 
6 6 6 6 7 5 1 1 1 1 1 1 1 1 1 1 1 1 1 1 1 1 1 33 33 33 33 33 3 7 1 15 13 13 13 13 13 13 13 16 1 1 3 7 0 0 0 0 7 6 
6 6 6 6 7 5 1 1 1 1 1 1 1 1 1 1 1 1 1 1 1 1 1 33 33 33 33 33 3 7 1 1 15 13 13 13 13 13 13 13 16 1 3 7 0 0 0 0 7 6 
6 6 6 6 7 4 4 4 4 4 4 4 4 4 4 1 4 4 4 4 4 4 4 4 4 4 4 4 4 7 7 7 7 8 31 9 10 7 13 13 16 1 1 7 0 0 0 0 7 6 
6 6 6 6 7 7 7 7 31 7 7 7 7 7 7 31 7 7 7 7 7 7 7 7 7 7 7 7 7 7 12 12 26 13 1 13 13 7 14 13 16 1 3 7 0 0 0 0 7 6 
6 6 6 6 7 2 2 26 2 25 2 3 7 5 26 1 25 2 7 13 37 13 16 6 6 6 18 6 6 7 1 1 1 1 1 14 14 7 1 14 1 1 3 7 0 0 0 0 7 6 
6 6 6 6 7 5 1 1 1 1 1 3 7 5 1 1 1 3 7 13 36 13 16 6 6 6 6 6 6 7 1 1 1 1 33 1 1 7 1 1 1 1 3 7 38 0 0 0 7 6 
6 6 6 6 7 5 1 1 1 1 1 3 7 5 1 1 1 3 7 14 13 33 33 33 33 33 33 6 17 7 17 1 1 33 27 33 7 7 7 31 31 31 7 7 31 7 7 7 7 7 
6 6 6 6 7 5 1 1 1 1 1 3 7 5 1 1 1 3 7 6 6 33 33 33 33 33 33 15 13 7 13 16 1 19 19 19 7 6 6 33 33 33 6 6 6 7 0 0 0 7 
6 6 6 6 7 5 1 17 17 17 17 3 7 5 1 1 1 3 7 6 6 33 33 33 33 33 33 15 13 7 7 7 7 7 7 7 7 6 6 33 33 33 6 6 6 7 0 0 0 7 
6 6 6 6 7 5 15 13 13 13 13 16 7 5 1 1 1 3 7 6 6 33 33 33 33 33 33 15 13 13 16 6 6 6 6 6 6 6 6 6 6 6 6 6 6 7 0 0 0 7 
6 6 6 6 7 5 15 13 13 13 13 16 7 5 1 1 1 3 7 6 6 33 33 33 33 33 33 6 7 7 7 10 7 7 7 7 9 7 7 7 7 10 7 7 6 7 0 0 0 7 
6 6 6 6 7 5 1 14 14 13 13 16 7 5 1 1 1 3 7 6 6 15 13 37 13 16 6 6 7 2 17 17 2 2 2 2 15 13 17 17 17 17 3 7 6 7 0 0 0 7 
6 6 6 6 7 5 1 17 1 1 13 16 7 5 1 1 1 3 7 6 6 15 13 36 13 16 6 6 7 15 13 13 16 1 1 1 15 13 13 13 13 13 16 7 6 7 0 38 0 7 
6 6 6 6 7 5 17 13 17 1 14 3 7 5 1 1 1 3 7 7 7 7 7 7 9 7 7 7 7 15 13 13 16 1 1 1 1 15 13 13 13 13 16 7 6 7 7 31 7 7 
6 6 6 6 7 17 13 13 13 17 1 3 7 5 1 1 1 3 7 23 2 2 2 2 2 2 2 17 17 13 13 13 16 33 33 33 33 33 14 14 13 13 16 7 6 6 6 6 6 7 
6 6 6 6 7 13 13 13 13 13 16 3 7 5 1 1 1 1 1 1 1 1 1 1 1 1 15 13 13 13 13 13 16 33 25 22 26 33 1 13 13 13 16 7 6 7 7 7 7 7 
6 6 6 6 7 14 13 13 13 13 16 3 7 5 1 1 1 3 7 23 4 4 4 4 4 4 4 14 14 14 14 14 1 33 21 33 20 33 1 14 13 13 16 7 31 7 6 6 6 6 
6 6 6 6 7 5 15 13 13 13 16 3 7 5 1 1 1 3 7 7 7 7 7 7 7 7 7 7 7 5 1 1 1 33 25 19 24 33 1 1 14 14 3 7 6 7 6 6 6 6 
6 6 6 6 7 15 13 13 13 13 16 3 7 5 1 1 1 3 7 7 7 7 7 7 7 7 7 7 7 5 17 17 17 33 33 33 33 33 1 1 1 1 3 7 6 7 6 6 6 6 
6 6 6 6 7 5 15 13 13 13 16 3 7 5 1 1 1 3 7 6 6 33 26 18 25 33 6 6 7 15 13 13 13 13 13 13 16 1 1 1 1 1 3 7 6 7 6 6 6 6 
6 6 6 6 7 15 13 13 13 16 1 3 7 5 1 1 1 3 7 6 6 6 33 33 33 6 6 6 7 15 13 13 13 13 13 13 16 1 1 1 1 1 3 7 6 7 6 6 6 6 
6 6 6 6 7 15 13 13 13 13 16 3 7 5 1 1 1 3 7 6 6 6 33 27 33 6 6 6 7 4 15 13 13 14 14 14 4 4 4 4 4 4 3 7 6 7 6 6 6 6 
6 6 6 6 7 13 13 13 13 13 16 3 7 5 1 1 1 3 7 6 6 6 33 33 33 6 6 6 7 7 7 7 7 7 7 7 7 7 7 7 7 7 7 7 6 7 6 6 6 6 
6 6 6 6 7 15 13 13 13 13 16 1 7 5 1 1 1 1 7 6 6 33 6 6 6 33 6 6 6 6 6 6 6 6 6 6 6 6 6 6 6 6 6 6 6 7 6 6 6 6 
6 6 6 6 7 7 7 8 7 7 7 7 7 5 1 1 1 3 7 7 7 7 7 7 7 7 7 7 7 7 7 7 7 7 7 10 7 7 7 7 7 7 9 7 7 7 6 6 6 6 
6 6 6 6 7 15 13 13 18 13 13 16 7 1 1 1 1 3 25 2 2 2 2 7 2 2 2 2 2 2 2 37 2 37 2 37 2 37 2 37 2 37 2 37 2 7 6 6 6 6 
6 7 7 7 7 7 33 33 33 33 33 6 7 1 1 1 1 1 1 1 1 1 1 7 1 1 1 1 1 1 1 36 1 36 1 36 1 36 1 36 1 36 1 36 3 7 6 6 6 6 
6 7 0 0 38 6 33 33 33 33 33 6 6 1 1 1 1 1 1 1 1 1 1 1 1 1 1 1 1 1 1 1 1 1 1 1 1 1 1 1 1 1 1 1 3 7 6 6 6 6 
6 7 0 0 38 6 33 33 33 33 33 6 6 1 1 1 1 1 1 1 1 1 1 1 1 1 1 1 1 1 1 1 1 1 1 1 1 1 1 1 1 1 1 1 3 7 6 6 6 6 
6 7 7 7 7 7 33 33 33 33 33 6 7 1 1 1 1 1 1 1 1 1 1 7 1 1 1 1 1 1 1 35 1 35 1 35 1 35 1 35 1 35 1 35 3 7 6 6 6 6 
6 6 6 6 7 6 6 6 6 6 6 6 7 4 4 4 4 4 4 4 4 4 4 7 4 4 1 1 1 1 1 34 4 34 4 34 4 34 4 34 4 34 4 34 4 7 6 6 6 6 
6 6 6 6 7 7 7 7 7 7 7 7 7 7 7 7 7 7 7 7 7 7 7 7 7 7 7 7 7 7 7 7 7 7 7 7 7 7 7 7 7 7 7 7 7 7 6 6 6 6 
6 6 6 6 6 6 6 6 6 6 6 6 6 6 6 6 6 6 6 6 6 6 6 6 6 6 6 6 6 6 6 6 6 6 6 6 6 6 6 6 6 6 6 6 6 6 6 6 6 6 
6 6 6 6 6 6 6 6 6 6 6 6 6 6 6 6 6 6 6 6 6 6 6 6 6 6 6 6 6 6 6 6 6 6 6 6 6 6 6 6 6 6 6 6 6 6 6 6 6 6 
6 6 6 6 6 6 6 6 6 6 6 6 6 6 6 6 6 6 6 6 6 6 6 6 6 6 6 6 6 6 6 6 6 6 6 6 6 6 6 6 6 6 6 6 6 6 6 6 6 6 
